#######################
#_____________________#
#_________@___________#
#_____________________#
#___________@_________#
#_____________________#
#_____________________#
#___________$_________#
#_____________________#
#_____________________#
#_____________________#
#_____________________#
#######################
