#####################
#$__________@______$#
#___________________#
#___________________#
#___________________#
#___________________#
#___________________#
#_@_________________#
#___________________#
#__________@________#
#___________________#
#__________________$#
#####################
