#####################
#$_________________$#
#___@_______________#
#___________________#
#___________________#
#___________________#
#___________________#
#________________@__#
#___________________#
#___@_______________#
#___________________#
#$_________________$#
#####################
