#####################
#$_________________$#
#_____@__________@__#
#_____________@_____#
#__@________________#
#___________________#
#___________________#
#_@______________@__#
#___________________#
#___@_________@_____#
#___________________#
#$_________________$#
#####################
